Genesis -  Gen
Exodus - Exod
Leviticus - Lev
Numbers - Num
Deuteronomy - Deut
Joshua - Josh
Judges - Judg
Ruth - Ruth
1 Samuel - 1Sam
2 Samuel - 2Sam
1 Kings - 1Kgs
2 Kings - 2Kgs
1 Chronicles - 1Chr
2 Chronicles - 2Chr
Ezra - Esra
Nehemiah - Neh
Esther - Esth
Job - Job
Psalm - Ps
Proverbs - Prov
Ecclesiastes - Eccl
Song of Solomon - Song
Isaiah - Isa
Jeremiah - Jer
Lamentations - Lam
Ezekiel - Ezek
Daniel - Dan
Hosea - Hos
Joel - Joel
Amos - Amos
Obadiah - Obad
Jonah - Jonah
Micah - Mic
Nahum - Nah
Habakkuk - Hab
Zephaniah - Zeph
Haggai - Hag
Zechariah - Zech
Malachi - Mal